[infos_carte]
largeur= 30
hauteur= 30

[infos_joueur]
point_de_depart= 3 2

[tileset]
chemin_tileset= TS/TSbanquise.txt

[donnees]
7 7 7 7 7 7 7 7 7 7 7 7 7 7 7 7 7 7 7 7 7 7 7 7 7 7 7 7 7 7 
7 7 7 7 7 7 7 7 7 7 7 7 7 7 7 7 7 7 7 7 7 7 7 7 7 7 7 7 7 7 
7 7 4 5 5 5 5 5 5 5 5 5 5 5 5 5 5 6 7 7 4 5 5 5 5 5 5 6 7 7 
7 7 14 15 1 2 3 15 15 15 15 15 15 15 15 15 15 16 7 7 14 15 15 15 15 15 15 16 7 7 
7 7 14 15 11 12 13 15 15 15 15 15 15 15 1 2 2 2 3 7 14 15 1 2 2 3 15 16 7 7 
7 7 14 15 11 12 41 3 15 15 15 15 15 15 11 31 22 22 23 7 14 15 21 32 12 13 15 16 7 7 
7 7 14 15 21 22 32 13 15 15 15 15 15 15 11 13 7 7 7 7 14 15 15 21 32 41 3 16 7 7 
7 7 14 15 15 15 21 23 15 15 15 15 15 15 11 13 7 7 7 7 14 15 15 15 11 12 13 16 7 7 
7 7 14 15 15 15 15 15 15 15 15 15 15 15 11 41 2 2 3 7 14 15 15 15 11 12 13 16 7 7 
7 7 14 1 2 2 2 3 15 15 15 15 15 15 21 22 22 22 23 7 14 15 15 15 11 12 13 16 7 7 
7 7 14 21 22 22 22 23 15 15 15 15 15 15 15 15 15 16 7 7 14 15 15 15 21 22 23 16 7 7 
7 7 14 15 15 15 15 15 15 15 15 15 15 15 15 15 15 15 5 5 15 15 15 15 15 15 15 16 7 7 
7 7 14 15 15 15 15 15 15 25 25 15 15 15 15 15 15 15 25 25 15 15 15 15 15 15 15 16 7 7 
7 7 14 15 15 15 15 15 16 7 7 24 15 15 15 15 15 16 7 7 14 15 15 15 15 15 15 16 7 7 
7 7 14 15 15 15 15 15 16 7 7 7 24 15 15 15 15 16 7 7 14 15 15 15 15 15 15 16 7 7 
7 7 14 15 15 15 15 15 15 6 7 7 7 24 15 15 15 16 7 7 14 15 15 15 15 15 15 16 7 7 
7 7 24 15 15 15 15 15 15 15 6 7 7 7 24 15 15 16 7 7 14 15 15 15 15 15 15 16 7 7 
7 7 7 24 15 15 25 15 15 15 26 7 7 7 7 24 25 26 7 7 14 15 15 15 15 15 15 16 7 7 
7 7 7 7 14 16 7 14 15 16 7 7 7 7 7 7 7 7 7 7 14 15 15 15 15 15 15 16 7 7 
7 7 7 7 14 16 7 14 15 16 7 7 7 7 7 7 7 7 7 7 14 15 15 15 15 15 15 16 7 7 
7 7 4 5 15 15 5 15 15 15 1 3 5 5 5 5 5 5 5 5 15 15 15 15 15 15 15 16 7 7 
7 7 14 15 15 15 15 15 15 15 11 13 15 15 15 15 15 15 15 15 15 15 1 2 2 3 15 16 7 7 
7 7 14 15 15 15 15 15 15 15 11 13 15 15 15 15 15 15 15 15 15 15 11 31 32 13 15 16 7 7 
7 7 14 15 15 15 15 15 15 15 21 23 15 15 15 15 15 15 15 15 1 2 42 41 42 13 15 16 7 7 
7 7 14 15 15 15 15 15 15 15 15 15 15 15 15 15 15 15 15 15 11 31 32 31 22 23 15 16 7 7 
7 7 14 15 15 15 15 1 2 2 2 2 2 2 3 15 15 15 15 15 11 41 42 13 15 15 15 16 7 7 
7 7 14 15 15 15 15 21 22 22 22 22 22 22 23 15 15 15 15 15 21 22 22 23 15 15 15 16 7 7 
7 7 24 25 25 25 25 25 25 25 25 25 25 25 25 25 25 25 25 25 25 25 25 25 25 25 25 26 7 7 
7 7 7 7 7 7 7 7 7 7 7 7 7 7 7 7 7 7 7 7 7 7 7 7 7 7 7 7 7 7 
7 7 7 7 7 7 7 7 7 7 7 7 7 7 7 7 7 7 7 7 7 7 7 7 7 7 7 7 7 7